      ############
      #        O #
      # XXP   ####
      #          #
#######       ####
#   O##      O#
#    ##       #
#           ###
#  X        #
#       #   #
#############