#####
#   #
# O #
#   #
# X #
#   #
# P #
#####